name: Author
material: classic
monsters: 2

------------------------------
---O---O---O---O---OOO OOOO O-
---O--O-O--OO--O--OO---O----O-
---O-O---O-O-O-O-OO----OOOO-O-
-O-O-OOO-O-O--OO--OO------O-O-
-OOO-O---O-O--OO---OOO-OOOO-O-
------------------------------
OOO------OOO--OOOOO----OOOOOOO
--------OO-------OO-----------
-------OO-------OO--------OOOO
---OOO--OO-----OO-------------
---OOO---OOO--OOOOO---------OO
---------------------0000-----
